20 19
XXXXXXXXXXXXXXXXXXXX
XX....XXX...XXX...XX
XX....XXX...XXX...XX
XX..........XXX...XX
XX....XXX.........XX
XX....XXX...XXX...XX
XXX..XXXXXXXXXX..XXX
XXX..XXX....XXX.XXXX
XX...X........X...XX
XX................XX
XX...X........X...XX
XXXX.XXX....XXX..XXX
XXX..XXXXXXXXXX..XXX
XX...XXX...XXX....XX
XX.........XXX....XX
XX...XXX..........XX
XX...XXX...XXX....XX
XX...XXX...XXX....XX
XXXXXXXXXXXXXXXXXXXX
4
3 3 1
16 3 3
3 15 1
16 15 3

